23 80
###############################################################################
#                                                                             #
#                                                                             #
#                                                                             #
#                                                                             #
#                                                                             #
#                                                                             #
#                                                                             #
##### ***     *                                                           #####
    #                                                                     #    
#####                *                                                    #####
                                                                               
#####         *                                                           #####
    #                                                                     #    
#####                                                                     #####
#                                                                             #
#                                                                             #
#                                                                             #
#                                                                             #
#  #                                                                          #
#  #                                                                          #
#  #                                                                          #
###############################################################################